nsp2f_pKISS_antarna_2	GGCGGCAAUCAAAACCAAUAUAUCACCCUCGCCUCCCGCCACGCGGACUCCCGACAUCGGUCGGGUUCCGCACGAUAUUCCGCAGAUCGGGUCGGAUCUGCCCUACUUCAUGACUAUACA
nsp2f_pKISS_antarna_1	GCAGGCAUCAUGACAAAUAGAGCGCACCCCAAUUCCCUGCAUAGAGCUACCCCGCGGGCGCGGGGCGCUCUCACGCUCACCUCCGUCCGAGCCGGGACGGACUCUCCCAAACCCCCCUUC
nsp2f_pKISS_antarna_2	GGCACCAUCACUACAACCAGUUUUUCAACAACCCCGUGCCCAGGGCGCCCUGCGGCCUGCCGCAGACGCCCAAAAAACACAGCCCCCCCACCCAGGGGGGCACCCAACCUACACCACGAU
nsp2f_pKISS_antarna_3	GUGGCACCACCUCAACUACGGCAUCAAUCCCUACCGCCACAACGGGCCCCAGACGCGGUCGUCUGCGCCCGGCAUGCCCAGCGGUCGGCCACCCCCGACCGACCCAAGACUCUCGAUUCG
nsp2f_pKISS_antarna_4	UGCGCUCCGUUCCCCCCCAUAUCGCAUCUCACCCCGCGCAACAAGUCUAGAUGGCACACGCCAUCCGACUUUCCGAUACCGCGGGGGCGACUUAGCCCCCGAAAACAAAACUCGAAUUCU
nsp2f_pKISS_antarna_5	CGGCCCCCCGUCAACCACUUGUUCCACACCUUCCCGGCCGGCACUGUCCACGGGCGCCCGCCCGUCACAGUCAGAACAGCACAGCGAAUCACCCUUCGCUGCCACGACACCACGCUUCCU
nsp2f_pKISS_antarna_6	GGCGCACUGCCCACUCCUUCAACACCCCUCCACACGCGCCCCGGACCCCGGCCAGACAGCUGGCCUGGUCCCCUGUUGUCCAGGGCCACGUAUAUGGCCCUCCUCCUACCCACACCGACC
nsp2f_pKISS_antarna_7	GGAUCAAAUACUUAUUACGUCGAAAACUAUUUUCAGAUCCUGUCCGAAGCAAUAUUAUUAUAUUGGUCGGAACUUCGAACAAUGCUUUCAAUACAAAGCAUCUCCAAAGAAUUUAUUUAU
nsp2f_pKISS_antarna_8	GCCUCCAUCAUGUCUUUCAGAACGCAACCCCUACAGAGGCACGGUAGGAGCCCCCGAGUGGGGGCGCUACCCCCGUUCGCUCCCGGGCAGCAACGCCCGGGUCUUCCUUCACACCUACGA
nsp2f_pKISS_antarna_9	GGCGCCCCCAUUUCUUCUUUCGUCUCAGUCUCCAUGCGCCCAGACCCCGUGGCCAGUUCUGGCCAAGGGUCCCGACGAUCCUGGCGGCCUAUUCGCCGCCAUCCACCACUACCUUACUGC
nsp2f_pKISS_antarna_10	GUCUGGAAUAACACAAUUAGAGGACAACCAACGAACAGACAACGGCCCCGGGACCAGGCGGUCCCAGGCCGGCUCCUCAACUCGCACGAAGGGCCGUGCGACAUACACAAUUUGCCAUCC
nsp2f_pKISS_antarna_11	CGACGAACCCACUCCACCCGCAGCCAAAUCCCACACGUCGAAGCGGGUCGACCGGUCGACCGGUCUCCCGCAUGCUGCACCGGCCCCCGUCCCAGGGGGCCUGAAACUAUCCCCUCCACC
ccr5_pKISS_antarna_2	GAAAUAUCCCCGCCCAAUUUCAGGAGGCCGGCAAAGAGUUGCCGGACGGGCGGGGACUACGGAGCUCCUACAAGCCACGCAAGCCUCCAAACUUCCCGAGGGCGCCUCUCAGCAGCGCCU
ccr5_pKISS_antarna_3	AGCGCACUCCCCGCCAGCGCCAAUUUGACGGCCCCCAUGGGCCGAACGGCGGGGAGAACCGGGGGGCCCCGACCCAACGAGAUCAAAUUUUUCAAGAGCCACGACGGCCGCAACGUCGAA
ccr5_pKISS_antarna_4	AACGCUCCGCAGGUCCGCGUCAGUCGGGCCGGCCUGUUGGCCGGGAGGACCUGCGGACACAAACGCGACCAAGCGAAUGCCCCCCGACACCCCCACCACUCCCUCAGUUACCCCGAGGAA
ccr5_pKISS_antarna_5	AGUGCAACCGAGCGCCGCACACGAGGAAGGGGGUGGGCACCCCCCACGCGCUCGGUCCAGAAACCUCACAGAAGGCCUCCAGUUCCUCUCACACCCCUACCCGCCGUAGCCCCCGGCGUG
ccr5_pKISS_antarna_6	ACCGUUUUUGGUUCUUACGGCCGGAUACAGUACAUGCUUGUACUAUCAGAACCAAACCUAGAGGACUUACACGUCAACUUACGUAUCCAACAUUUAACCGACCCACGGAAGGCAUGGGCA
ccr5_pKISS_antarna_7	ACCGGCCCAGGCCUCACCGGUCAGACAGCUUGGCCAUGGCCAAGGGAGAGGCCUGGAAAUUCCCGCAUGAGAGCGAAAAUACCUGUCUCCUACCACCCUUUUGCCAAGACCGACGGCACC
ccr5_pKISS_antarna_8	UUGGCGCCCCGCCCCCGCCAACAGUAUGGUCGCUACCAAGCGACAACGGGGCGGGGAAAGCUCGGCCUUACAGCCCUGCAAACAUACUUCUUAAUACUUCCGGAGGAAUCGUGUCUCCAC
ccr5_pKISS_antarna_9	AUUCUCCGCCCCCCAAAGAAGCGUCGGACGAGCUACACAGCUCGAAAUGGGGGGCGCAAGUUACAGAAUCCCCUGGAACCACUCCGACAGUCAAUCAUGCGCUGCGCACGGCUAGCAGCC
ccr5_pKISS_antarna_10	AGCGCACCGAGAGCAAGCGCAGUGCGGGGCUCCCUAAGGGGAGCAUAUGCUCUCGGAAGUCACCAGAUAACACUGCGGACAUCCCGCACAACAUCACACCUGGGCGGUUCAAACGCCCCU
ccr5_pKISS_antarna_11	ACAAUAGGGGAGACCAAUUGUUGGAGAACCGGCCAGGCGGCCGGAGCGGUCUCCCCCAGAGCCCCGAACGCACGGCGCUCAUUUCUCCCGUUUCAUAUGCCCUGCGCAACGAAAGCAGCG
sars_pKISS_antarna_2	AAGGACGGGACCCCUCUUGUCCUUGUGAGGGGUCCCCACGUGACCAAAGUACCCGGUCCACGUGCGAACGCGACAGCACACUUACAGCGCCAUCUCGCUCGUACUCUUUGCUGGCGCGGA
sars_pKISS_antarna_3	CACAGCACCGCCCGUUCCCCUGUGACAACGGGCGGUCGGGUACGAUACGGGACCUCGCUACCCGUGGCCUUCCACGGAGAGAUCGGGGGCGCGGACCCCACGAGAACGUCCGUAGAAGAA
sars_pKISS_antarna_4	UGUGCCAAAGACGUGGCCCGCACAUUCCACGUCUUUGUCCCCUCCUUCGCCCCCGGACGGGGACUCACUCAGGCCCGGACUUGGGGGGCUGCAAUGCCCUCCCUAUACCCGGGACUGACU
sars_pKISS_antarna_5	AAGUCGCCUCCCCAUGUCGGACUUUCCAUGGGGAGGGUGGGUCCCACAGUCAUAGGGCACCCACGCACCGGACUGGCGAAUCCGGCGACCUUUCCGUCGACCGCCCCGCGCCACUCCGCG
sars_pKISS_antarna_6	ACAGAAUCGCACGGGGCAAUCUGUCACCCCGUGCGAGUGGGAAGCGCCGCAUUAGCUAUCCCACGUCCCCGAAGGGCGCAUACUGCUGCAGCCCAGCAGUCAGACCAACGCCCCUCGGUC
sars_pKISS_antarna_7	AAACCCUAUCCUGCAGCAUGGUUUACCUGCAGGAUACGCCACGCUGUAUGUGUAAGCUGUGGCGCCACGGCAAAGGUGCCCCUAUGCGCUGGCAUGCGCGAUACCCACCACCUCUGCCCG
sars_pKISS_antarna_8	UCCGGACGCUCCAACCCUUCCGGAACGGUUGGAGCGAGCUUGGCGAUCAUCUCGCGCGCAAGCUGCUAUGCGAAGCUCAAGCGCCCCACCUCGCCGUGGCGGCCACCAGAGCUCCGCACG
sars_pKISS_antarna_9	UGUCAGCUUGCUUGUGCAAUGACAUCCACAAGCAAGGAGGGCGCCUCCUAUCCCGGCGGCCCUCGGGGGACCACGCUGAAACUCCUGCGAACACGCGCACGGACCGUCCAGCGAGGUCGG
sars_pKISS_antarna_10	GUCGCAGGUCGGGGGCAAUGCGACAGGCCCCCGACCGUGACCGGCCCAUGGCUCGCCAGGUCACACGGGAUCCAGGCGACAAAGUCGGGAGAUUACCCGCACUCCACGCGCCUAGAUCGA
sars_pKISS_antarna_11	UUUUGCGGCACCGCGGCCCCAAAAAUCCGCGGUGCCCCCGCCCCGGCACUGUCACGGAGGCGGGGAACGGCCCUACGAGCGCUUGCCGCGUGUAUGCGGUCAAAAAUAUCGUACGGCCCC
siv_pKISS_antarna_2	GUUGCAUCUGCGGUUUUCGGUUUCGAUUCGUCCCGAAAACCGCUGAUGCCAAUGAAAAACUUUCAUUUCCGGACCAUUCUACCAUACGUCAUAUAUAUUUGUUUCUCAAUUAUAUCGUCC
siv_pKISS_antarna_3	UCCUACCGUGGGUGCCGGCCAUCGGUUGCCUCGGCCGGCACCCCCGGUAUGCUGAACAAGGUUCAGCCAGGGGCACGGACUUACGAACUAAAUUUUGCGGAGGCCUUCCACAAAAAGCCC
siv_pKISS_antarna_4	AUCGACGCAGAGGUGCGGCCUUCGGACUCCUUGGCCGCACCUCAGCGUCCACGGGAAAGUUUCCCGUCAUCCGGUGCCACAGAGCUAACAGAGGACGAUCUGACAAAGAGCGUCCCCCGG
siv_pKISS_antarna_5	ACAACCAGGCUAGGAAAGGCCCCGGCCGCCUUGCCUUUCCUAGGCUGGUCUCGGGACCUUGUCCCGAUCAGCUCAGGCCAACACCGCAAAGCCCCACAGUUGGACGAACGGUGGGAGAGC
siv_pKISS_antarna_6	UUGUGGCAAUUCGAGAGAUUAAAGCGUGGCAAAAUCUCUCGAAGUGCCAACUUCUUGCAACAAGAAGCCACCCGCGACUUUCUUCCAUUCCUCCCAGGUCACCAUCUGAGCUGGGUCGGG
siv_pKISS_antarna_7	GUAGGACUCCCAUCGACCAGGCCGCAAUGCUACUGGUCGAUGGUAGUCCCGGAGUCCGAAGGACUCCCAGGGGCACCAGCUACGGAGUUAAACCACACGCCAAGUCGGCAUGUGGAGCCC
siv_pKISS_antarna_8	ACGGGCCACGGCGCGGCUCCCCAGCGCAGCACGGAGCCGCGCCCUGGCCAGGCUUGCCUUGCAAGCCCUACGAGACCAUUACCGGAGAAAUCGAGCGACAUCUGGCAUGGCGCUCACUCG
siv_pKISS_antarna_9	UACGGGUUGGCAUCGCGACUCAAUGGAUCAGAAGUCGCGAUGCAAACCCUGCAGAUCAACGAUCUGCCCCCCGCUUCUCCACUGACUGUAACGCUCGCACGUCACUCGUCCGAGCCGCGG
siv_pKISS_antarna_10	CCCUCCGCCUCGGCCGUAGGAACAUCAUAUCACCUACGGCCGAAGCGGAUGGGCCCUGUGAGGGCCCCCUGGACCGCAGACCCGCUACAUACGGACGCAUUACCCAAAUACGUCCCGUCC
siv_pKISS_antarna_11	CUAUCGUCCCUUCGUGCGCCUCUCCGCAGGCCGGCGCACGAAGUGACGAAGGGACGCCUGGCGUCCCACUCCUCACCUUACACGGCCCAUUCGAACCGGGAACGGCUCCGGGUUCAGAGG
srvl_pKISS_antarna_2	CAUUACCGCCCCGCUUCGCACGGGGCAUCCUGCCGACCUGCGAAACUAUCGGCUAUACUGAACCACCCAAAUCCCCUCCGGGAAAUCGACGUCUCGAACUCAGCGCCCGGACCACUCGCU
srvl_pKISS_antarna_3	CCGAACAGCCUCGACCGGCGCGAGGCACUCCCGGGCCCCGCCGGACAUGCCCGAACGACCUACACGAACCUACCACGCCCCCCAAGCCCAUCCGGGCGUUCCAAUGGGGGCAACAGAUUG
srvl_pKISS_antarna_4	ACUCACACCCGGGCUGCUUUCCCGGGACCCAGCGGCAAAAAGCAGAGAGCCGCCCCCCCGACCAUCAUCAGAACCAGCUCCGAGGGCGGCCCCCCGCGAUUAGAUCGGAGCCCCUCAUCU
srvl_pKISS_antarna_5	UCAACUUGGACCCCCUUCGCGGGUCCCCCCAGCAUCAAGCGAAGAUUCGAUGCCCACCCAAUGACAGAACAACCACGGCGCCACAGCCCUCCUGGGCCCUAUCCGGGCGCCUUCCGCGGA
srvl_pKISS_antarna_6	UCCAUGGGGAGGGAUUCGGCCCCUCCCCUCUCGCUCAGGCCGAACAACGAGCGCGCACCACCACCAACACAUCGCCGGCGCGACGACCGAUACCGGUGCCCAUCUCGCGCCAACAUAGAU
srvl_pKISS_antarna_7	UUACACAGCUGCGAGCUCCGCGCAGCCCUAACCGACAACGGAGCCAAGGUCGGGCACCUCAAAACCAAAUCUCAAUGCGCCCCAACGCCGUUCGGCGCUCAGUAUGGGCGCUUACUAUAC
srvl_pKISS_antarna_8	AGCCACACGACAGCCUCUCGCUGUCGAUUCAGGGGCGACGAGAGCUGGGCCCCGAUACAUCUCCAAACCGACCAACCGGCCGAACCCGCACCUGCGGCCUUAACGCGGCCGUCAGCCGUU
srvl_pKISS_antarna_9	ACUACCAGCCGCCCCCGUAUGGCGGCGCAGAUGGAGCAAUACGGACUACUCCACCAAUCCCCCCCCUAUUUACCCUGGCGCGAGAGCCCACUAGGGCACACGGAGCGCGCCCACCACUCC
srvl_pKISS_antarna_10	UACACACCAGGGGAACCGAGCCCCUGUCCCACGCUGCCCUCGGUGUCCCAGCGCAAAGACUACAAGACCACAUACACGGUGCACCCGCCUAUUGGCGCCGCGAAUGCACCGGACCGAUUC
srvl_pKISS_antarna_11	CGCAAACGGCACCAACGUCGGGUGCCCUCUCGCUGCUACGACGUGAAUGCAGCAAUCCCCAAUUUCACGCACGACUGGCGGCUAAGUGCCGAUGCACAACACAUUGCCGCCCAAACAAUG
plrv_pKISS_antarna_2	AUCAAGGCCGCAAUCGAAUGGGAACCAACACCAGAACACUACAGAACAACCGCGGCCCACCCCUUCAAAUCCGAGCCACCUGGAGGGAUAUCCCCUCCCCAAAGCUGGAUUCGUGUCGAA
plrv_pKISS_antarna_3	UUUCCCGGCGUCAACCCCCGCUUACUACACGCGAAGAGACCCAAACAUAUUACGCCGCCUCACCCCCGCCGGACCCGAGCAGCCCAUUCUUCAUGGGCCCCAAGGGCCGGCCUCUCCCCG
plrv_pKISS_antarna_4	UCACUGCGGCCCGAAACCGCGACAACCCCACGCACCUUAAAUCCCACCUACGGCCGCCCAUACAAAAGAUCGCGCCCAUGUCGCGGGCUCCCCCCGCGUAUUCGGCCGAUCAUAAGGACA
plrv_pKISS_antarna_5	UCCCCGCGUGUAGAAACCGCCAUACCAACCGGCCCGAUGCCACCCAAAAACACACGCUACACCACUCACUGCUCGGCCCACGCGGCCGGCAGGGCCGCCACCUCCGGCAGUCCAUCUCCU
plrv_pKISS_antarna_6	UUCCACAGUCGAAACACAGCGAAUACAGACCGCGAAUGCCCACCCACCCCACGACUGACUCUCCCCGCGGGACGGCCCCCCCGGGGCACGUCGCCCCGAUUCCGCCUCCCGAGCAUGCAC
plrv_pKISS_antarna_7	UUUAUAGCCGAAAACACUGGCUCACUCAAUGCCUCUUCCCUCCCCACCUCCUCGGCUCCACUUAUAAGAAUGGUUAUUAUCCUGUCGCGAACCGACAGCCCCUUAACAUUCCGGAACCAA
plrv_pKISS_antarna_8	GUUACGCGAGCCACCUUCGCAUCACCCGUUUGCUCAUCGUCACCAUCCCCAGCUCGCACUACCAUAGUGGGCACCCCAGAACCGUUUCCCGCAAACGGCCACAGGGGCCCAACGAUCUUU
plrv_pKISS_antarna_9	UGGUCCGCGCUGCAAUUAGACACCCCACAAGUCAACCAGAUAAACAGAAAGAGCGCGAUACACAAAUCCUGCUGCUCCUCUCACCUGCAGCUCAGGUGCUCCAAGCGCAGGUCUGGAACC
plrv_pKISS_antarna_10	CGAACGGCCGGACGAACCGACGAACCCACAGUCUUGAAACAACCCUCCCACCCGGCCCACCUCCCGCCGCUGGCGCACACGCCCGCGCCACUCGCGGGAACUGGCGCAGCGAUUUCACGA
plrv_pKISS_antarna_11	CAAUUGCCACGUUGUUUAGCACACCCCCCCUGCGUCUUACUACCCCCUUCCCGUGGCUCCUCACCAAGGCCCAUCGACACCCCUGUGCGCCCCACAGGACGCCCGAGGGCCGUAAGCACC
oaz_pKISS_antarna_2	CGCCACGAUGUUGCGAGGGCAUGGCAAGCGCAACUUCGUGAAGGGUCGAGCAUGCCGAGGCAUGCUACGCACACGCCCCAUCCCGCUGACAGCGCAGGGGCCCAAGCUCAUACCCGCUUC
oaz_pKISS_antarna_3	AAGCCCCUCCCGCGACACGCACUGCCACUCGCGGCAGGGGAGCCGCUUCGACGAGUCCCCUCGUCGUAUGGAGUGGACACCCCGAACAAAGUUCCCUGUCCUGUACAGUCUGCGGAUGUC
oaz_pKISS_antarna_4	UGCAGCGGAACUCCGAAUGCGCUGCCCCCGGAGUCCCGCUAUGAGCCAGGGGCCAAAUCUGGCCCCGAGUCUACGCCUGUCGACCUCGCCGAGGAUCAGGCACAAACGACCGCUCUCAAC
oaz_pKISS_antarna_5	AUGGCGAGCCGACGGCCCGGAUUCCACCCCGUCGACUCGCGACGGAAUGCGAAGGCCGACCUUCGCCCUCAUAGCUCGCAGAAGCUGCCCCAGCCCGCGAGAACCGAUCCAUCCGACUCA
oaz_pKISS_antarna_6	AUCGGAUCGGCCGAGCAAGCCCGGCAGCCUCGGCGGAUCCUCCUCCAUACCCGCCUGCCGGCGGGUCCAGACUCGCGUUCUGAACAUACUAUGUAUAACGCCCGCCUACCCGGAGAUGUG
oaz_pKISS_antarna_7	AGGGACCAAACGAUUCAGCGGGACGAACAAUCGUCUGGUCGGCCGACUGUCCGCCCAUGGGCGGACCCGCAAUACCGGGACCUGCGUAGAACGCCACCCGGAGCAGCUUCCUCGGGAACG
oaz_pKISS_antarna_8	GUUCGCUGCCCAGAGUCCGGCGACCUCCCUCUGGACAGCGUUUCUGACCCGGCCGUGGGCGGCCGGACGCCAAUCGAGCAUAAGGGCGAGGCCCGAGCUCGCCAAGCAAUACAGAUCCUC
oaz_pKISS_antarna_9	AUGUGUGGAGGCUCCCUUGAUAUUCUUAGGAGCCACCACAAAGAGUAUGCCCCCCGUCGGGGGGGCGCCGCACAAAAACCGAAGCGCUUUGCGCCUGUUUUAUACCGACCCACUCACACC
oaz_pKISS_antarna_10	AAUAAUAACAUGCGGAGAGUACGACAGACCGCAUUUUAUUCCGAAGUUUCCUCUCCGCCGAGAGGACUGGAUAUUCUGGGAGUCGGCAUCGCCGUACCAGACAAGCCUCGCCUUCAAAGG
oaz_pKISS_antarna_11	CCUCACUGCGCCCGUCGCGGUGCCCUUCACGGGCCCAGUGUCCCUGGGCGACGGCAGGGGCCGUCGAGAAAACAGUGCGACACGGUCGGGGACCAGCGCACCAAUUUGGAACAGGACGAG
herpes_pKISS_antarna_2	GUCUUCCGUGGGGCCCAAAGACAAAUAGACCUACCCAAACGGCGCGCGAGUGCCCCGCGCGCCGCAGCACACCGCCUCCUCACAUUGAACCGGACCCUGCUGGCCCCACGCCCUGUAGGU
herpes_pKISS_antarna_3	GUACACCGCGCUGGCCAUGUACAACCUCUUCCCUACCUCAGCCGCCCAAAGAGACUGGGCGGCCCGCAAACGGCGAGUCACCCUAUACAGGCCCAAGCGGCGCCAGCGCGACUAAGGGAG
herpes_pKISS_antarna_4	UUGAGACUGUUCGGGCUCUCAAAACGAAAACGACUCUCAAGUCCCCUCAGCUGCAGAGGGGACGGCCCCCCGGGCACGAACUACUGCGAACCCCUUGGCCCCCCGAACAGAACCGUCGUC
herpes_pKISS_antarna_5	GGCGCAUUGCUCUUUACGCGCCAACACAUCCCCGAAAUACUCCGACGAAAGAUAGUCGUCGGAUGCCCGAAGUCGCGCAAUGCAGAGCCGGACAAAGGCAAAAAGAGCAACCAACGGGGG
herpes_pKISS_antarna_6	GUUGCACACUUUGUUACGCAACCCCUUCUGCCCCUUUUAUUGCCACGCAUUCAACGCGUGGCAGGGCCCUCCGGUCGCACUCUCUCGCAUCCGCUCGCCCCAACAAAGUGCUUCGGGGCU
herpes_pKISS_antarna_7	UGUUUCCAGGCGGAGGAAAACAUCCACAUCCCCAUCUCCUCCCGGACUCCCGGCCAGUCCGGGGGCUGUUCGCACAUUACUACACCAAGCUGCCCAAGCCACUCCGCCUGCUGUUGGGGG
herpes_pKISS_antarna_8	GGGAACGAGCGCCCGAUUUCCCAAAGACAGCCCCCACAGAGGAGAGGCACGCGAAGCCUCUCCCGCUACUCACUGAGGACACGAUACCAAAGUAUAAGCGACGGGCGCUCAAACGGGGCG
herpes_pKISS_antarna_9	UUUCUCGUGACGGGGAUAGAAAGAGAGAUAGACCUGAGAGGAGACCCGAGUCACGCGGGUCUCGGCGACUACGUCCGCAGAAGACCGCUCACGCGACGCCACCCCGUCACUGUUGGUCUA
herpes_pKISS_antarna_10	GGCCCCAAUGCGAAAACGGGCCAACGUUUCAGGGCGUCCUGGCCCAGGGUAGGAGCCUGGGCCGGUCCCAAGCUACAAGAUCGACAUUCCAGCAAAGACCCUUUCGCAUUAAAACCCUGC
herpes_pKISS_antarna_11	GGCAUACCGACCGCCGAAUGCCUAAAACACCUAACUAUAUUCCGCUCAGUAGAUAUGAGCGGACCCGCACCGAAUCGACAAGAGCAUCACUUCCCACGGGAGGCGGUCGGAUCAUUAGGG
peg10_pKISS_antarna_2	GCACGGGAAAUGCCCUAUCAAGACCGUACCAAAUCAUUUCAAGUCCUCGACGGUCUUCCAUCCACUGGGUCCAGUGGUCACCGAGACGUCGGCGUCGUUGCCUGCAUAUGGGAAGACAAG
peg10_pKISS_antarna_2	CCAACCGUACUUCGGAAAGGGGGCGCUCCCAUCAAAGUCCCUUCCACUCAGCGCCCCAUACCGCGCAACACUGCGCGCACAGGCUUGUGCCUCGGCUCACUCAACCCUCGAAUGGCCUCU
peg10_pKISS_antarna_3	AUAUGGGAGACGCCCGAACGCGGGGCUCCACUAACGUCACUCCUCUACAAGCCCCGCCAUAUGCGCCUUCCGGCGCACCCCUGCGGAAGCAGAGCCUACCGGACCCAGCCCUGUGGCACG
peg10_pKISS_antarna_4	CACAAGGACUGCCCUACAUGGCCCCGCAACACCCGCAGACUCACCAAGAGCGGGGCCCCAGCCCUUCAGUCGAAGGGAUCGGCGGACGCGCCAGUCACCGGCACACUACGCGGGGACAAA
peg10_pKISS_antarna_5	UCAAGUCCGCGAGACAUACGCCGCCCGACUCCCCUCGCAAAAUUACCCCCGGGCGGCAACAGGCGGGAUGCCCCGCCGACCCCUGCAGAGGGAGCAGCGAUCGAUACGAGACCGUGCACC
peg10_pKISS_antarna_6	AACUGGCCGGUUGCCCACCCUGCGCCCCCCCACAAACCUCCACCCCUACGGGCGCAGCCCCAGCCUGUUUCCAGGCUACCGACGAAAACGUCCCCGACUGCACACCAAAUGGAGCGGACC
peg10_pKISS_antarna_7	UUAAGCCAGCAAGGCACAGCGGGGCCCCCACACUUUGCCCCUACCCCAAGGGCCCCGGCACGUGUCCAUGCGGACACACACCGCUCAAGCGGAGUGAGGUGCACCAAUCGCUCCCACAAG
peg10_pKISS_antarna_8	CUAGUCGAAAUGCGAGCCAGGCGACGGGUCCAACCAUUGAGCAUCACUACCGUCGCCACACGAAUGGAAUGCCAUUCCUACAUGGAUACAUGCCAGAGAAGGUACCCCCCCAUCCUGUUA
peg10_pKISS_antarna_9	CCACGGCCUUCUGCCAUAACCCACUCACAGAACAAGAACGGCGCUUACAUGAGUGGGCCAUUCGGGCCCCCGCCCGAUCCGUCCCGGAGGACCGCGUCACCGAUCAACCCGCUGCGCACC
peg10_pKISS_antarna_10	ACAAGGCGCUCAGCCCAACCGGCGGCGACCAACCUGAGCCGAUUAUCUACGCCGCCGACUUGCCGGCAUGGGCCGGCCACGAGGUCAGCCUCAUCGACAACCCCUCCAAGGAUGCGAACA
peg10_pKISS_antarna_11	ACAAUGCAAGUGGCAACUCGGAGUCGAAAAUCCGCACUCCCAACACUGAUCGACUCCUAUCCUGCGUGUACACGCAGAAACCGAAUAUUCGGGGAACGGCGCACCAACCGCACCUUCGGA
rous_pKISS_antarna_2	AUUUCCGAGGCACGAAUGAAACCCACCCUCUUCUCCCCUGGCAGUCGGUGGUACGACCCAGGGGCGCGGAUCCUUCCGCGGUACCCUCGUGCCUCCUCCAAUCCGGUAAAAAAGAAGAGG
rous_pKISS_antarna_3	CAGGCAUCCGUGAUUCCGCCAACGAUCACUCUGUGCCGUACCUUGGCCGGUCAGCCAGUACGGCGGGAAAAACCUUUCCCCAAUUUAAUCACGGACAGCAAAAAGCAAGAGUACAGAGUG
rous_pKISS_antarna_4	UCGGGGAGGACGAGGACCCCAGAAUUGAUCUCCCUGCGGCCCAGCGGCAGGGCCCGCGGCCGCAGACCGAGAGUUCGGUCACCUUACCUCGUCCUAUGCAAUCCGCACAUACGGGAGAUC
rous_pKISS_antarna_5	CAGCACAGGUUUGGUGGUGCAGCUCCGGUAGCCCUCGGUUGCUUGACCGUCGCGUCACAACCGAACGCGCAGUGGCGCGUGAAGACACCAAACCUCACCGACACGGAUACAAGGGCUACC
rous_pKISS_antarna_6	ACCCGCGCAGUUUGGCCCGGAACUCCCUGCGCAGACUUGCCCUUGGGGUCUCGCCCAGGCAAGUGGGUGCGCGGGCACCCGAAACUCCAAACUGCAAACCACCCGUCUACACCUGCGCAG
rous_pKISS_antarna_7	CCGGGCAUAAGAGGUCACCCAUACGUCCUCAGCGCGUGGUAUUCCUGGCUAGGCAGGUACCACGGCCACCCCAAGGUGGCACGACAACCUCUUAUUUAUUUGCCAUCACAUACGCUGAGG
rous_pKISS_antarna_8	UCCGCAGUUUCGGCCCGGCGAUUAAGGGGGUGGGGUGGCCGACGGCAAUCGGGUGCCCGGCCACGGACUGUGCUCAGUCCACACAAGGCCGAAACAAGCAGACCGCGUAUUUCCCACCCC
rous_pKISS_antarna_9	GUUUCGGAUCGGGGGUCGAAGAAAAAAGGAAGUGCCAGGGGUCGCACGUCCCGGUGCCCCCUGGGGGCGUGCCAACGCCCGAACCCCCCCCGAUCAAGCCUCCCGCAACUACCACUUCCU
rous_pKISS_antarna_10	AACGGCAUAGAGCAGCACCGAAUCCAGCGCCCAGGCGGGAGGUCCGCACCCUCGCGGCUCCCGCGGGCUCGGUGGAGCCCAAUAAUCUGCUCUAUCCUUCUAAAAAUGUUCCCUGGGCGC
rous_pKISS_antarna_11	CAGCCAUCGCUCCAACAGGCAACGCAGACGGAUCGGGGACCCUGGGCCCGACCGCCCGGUCCCCGCGGAGGCAACUCCGCUAUGAAUUGGAGCGAACCCAUCUCGGGACCACGAUCCGUC
hcv_pKISS_antarna_2	CGGUCGAGGAAAAGGCCGAAAAAUUCGGAAGACAUUGGGUCUAAGAAUUUUUCGUGCAUCGGACCGGAAGGCUUUCUUUUCCCCACGGAACAUGCGCGGAAGCAUCCCGUGGUGCCUAUA
hcv_pKISS_antarna_3	GAGAAACACGCAAGCGAUCCUCCGGAAAAGCUGUUGUCCAGCGGUCCGGAGGAUACGACAAUUCUCACGCCCGUACUUGCGUGGGCCCCCCCGCCAGCCUGGGCGAGGGCCCAGGGCAAC
hcv_pKISS_antarna_4	GCCCCUAGAAAUAAGCCUUUCUUGUGCAGUCGACAACCUCGAACCACAAGAAAGUGCGCAUGGGGCUCCGGCAAUUUAUUUCAACCUGACAAGGGGCCCGGCCCUACAGGUUCGCCGUUC
hcv_pKISS_antarna_5	GGCUCACGUGCAUGCGCGCCCCCAGCGGAGUUUCACGCAAACGGGCUGGGGGCGACGAGAAGAGCCCGGCCGAAUCAUGCACUGGCCACACUGCGAAUGCGCGCAAUGGCCAACGGCAAA
hcv_pKISS_antarna_6	GCCCACAUGCAAGACCAUGAUACCAGAAACUUCACGAGGAAGCACUGGUAUCAUCGGAAGAUGGGCGAGGCUGAAUCUUGCAGAGGUCCUAGAGGAGCAACCCUCAGACCUCAAGCCAAG
hcv_pKISS_antarna_7	GCGGGCAGAAACGAGCCGCGGGCCCCCCCGCCCGCGGGGGGCCAGGGGCCCGCGAGCGGACCCCGCAAGGAGAAAUCGUUUCACGUAUCUUGGCAGGUCUAUGCCCAUACGUCCUCCAGU
hcv_pKISS_antarna_8	GCGUGCAACUCAAGCGGGCGGCCGUCUCAAGCGGGAGGCGCUACGACGGCCGCCACGAAACCACGCAACGGCCAACUUGAGUUUCGGCCCAGCCGCGAAAUCGGCAGCCGAAUGCCGGAA
hcv_pKISS_antarna_9	UGGGAGAGAAGGAACGGGCCGUAUGCCAGGUGCCUCUCGCACAUGCAUACGGCCACGAGCAUCCCAGAGGCCCAAUUCCUUCGGACCCGCCAGGGGGAACACCCUAGGGUCCCGGCCAAA
hcv_pKISS_antarna_10	GCCGCGAAGAAUAGUCAUCCUUAUCCGAUCAGAUACGCUCUGCGGGAUAAGGAUCGAAGAAGCGGCAAUCCCAUGCUAUUCUCACUGGCACCAUGGCUUGUCAUGCCCAGUGCGGGAGAU
hcv_pKISS_antarna_11	GCUUCCCUACCUCGGGCCCGCUGGCCCCCCGCGACAGGCGCGCAGGCCAGCGGGACCACCAGAAGCUCGGCUGAACGAGGUAUAUCCGGUAUCCGCCUCCACGGAACGGAUACAGCCACG
herv_pKISS_antarna_2	ACACCUCUAUGUCAGUGCGCGACAUACCAAUUAAAGCGCACGAAACUCACAAGUCCCAGUCCUCCGACGCGGGAUUCGGAGGACCCCCGCAGGCUCCAAUCAGCCAUAAUAUUGAACGAU
herv_pKISS_antarna_3	UUCCUUCCGUCUCAGCGGCGGAGACGCCCCCACCUCGCCGCACCAACACACCACCCAUGGGUGCCGCCACGACUACCGGCACCCUCUCGUCCAUACCCGCAUAUGCCCCCGCGGGUGAAC
herv_pKISS_antarna_4	AAACAGACAGAGGGGGCCGCCCUCUGCAACCCCUCGCGGCCAACACCAACCUAUCGCGCCGGGCGCAAUGUCCCAGGCGCCCGGACGACACGGUCACGUCCGACCCCCCAGACGAAACAG
herv_pKISS_antarna_5	UCAUCACACUCGGUAGGCGUCCGAGUUCCCACAAAACGCCUCAAACAACUUCUUAUUACUGCCCGCCAAGAGCGCAGCGGGCAGCCCUCUCGACAAGGGCCUGUCUAUCCGCCCAAUCCA
herv_pKISS_antarna_6	AGCCACCGCCGCCCGUUAGAGGCGGCCCACAUAAAUCUAACUCAUCCCCUCUCCCUACGGGGCGCGCAACGAGUCUCGCGCCCCUAUCGUCCCCCAGACGAGGGGGACAACGUCCCCGCC
herv_pKISS_antarna_7	UACCCACCGCGUACGCACAUUACGCGAUCAUGUCCAUGUGCAAACCUAUUCACUUACCCCCGCGGGAGCGGGCGGUCCCGCGGGACCCCGCGCGCAGGGAAGCGCGCUACUCCCUCCCCG
herv_pKISS_antarna_8	GCCCUAAGACGCGCUACGGCCGCGUCCUACCCAACGCCGUACCCCCCAGAUCAACAACGCCGGGCGCCUAUGCCCACGCCCGGCAACAUAAGCGACGACCCUCGCCAGAUGGUCACCCCC
herv_pKISS_antarna_9	UUUCCCCCGGGCGUUCUUCGCGCCCGAACUAUCCCCGAAGACACCCCCUACACCACUACCCCCGCACGGAGGAACAUGCGGGGGCUCCUCCGACCCGGUAUGGUCUAUCUUACCCACCAU
herv_pKISS_antarna_10	CACUCCACCCCGCUGAGGCGGCGGGGACUAACGAACGCCUCACAUCAUACACUACCCUGGAUCGCCUUCGUACCCCGGCGAUCCCUUACGCCUGCCGGUCCGCAGACCAAGACCAACGAC
herv_pKISS_antarna_11	UCACCCAGGUACCCCCCCGCGGUACCCCAUGCAACGCGGGGCCAACAAAUCCACCACCGCGGGCGCGACAUGCAGGGCGCCCGCAACAUGCGCCUCGAAAUAGGCAGAGAUUUCAACCCG
influenza_pKISS_antarna_2	UUCAAAGCCCAGGUCUCCACUCCAAGCCCCCCAAUCGGGGCACGAUACCCGACGCACCGCACGACGAGGUCCCCAAGGAGUCAACGUUCACCUGGCCCACAACAUUACACCCAUGCCACU
influenza_pKISS_antarna_2	CACAAAACGGCGCCUUUUGAGAGUCCUUCCACCCGAGGAAGCCCCAUGCCGUGCCACCACCGCCCGUGCACCCCUCCUCUCCCCUGUCCGGCGCCUACCAGACCCCUCAAAAUCACUCCA
influenza_pKISS_antarna_3	UACAUUUUGGGGGAAAAACGGCCCAGACGUACCACCACGUCAUCCCGGCUCACGACCACCCCGCGACGCCAGACCCGGCCGCUCCCAUAUCCCCCCAUCCAUGCAUCCUCAACCGCCCGU
influenza_pKISS_antarna_4	UCACCCGCGAGAGCCGCCGCCCGAACUGCCCAGAUCGGCAGCACAACGCCCAGCGAGCUAUGCAGGAGCGGAAACACGGGCAAAAUUCAGCUCUCCAACCGAAAACCCAACCCUCGUCCC
influenza_pKISS_antarna_5	CCCCCAAUCAUUGCUUCAGCGGCCCGCAACGAGCCAGUUGCACCCCCGCCGCGCACUAUCCGCACGCGCGUCAACCGCCGCCCCCGUCCGCAAUGUUCCAGACUGUCCACACCCCCGAGA
influenza_pKISS_antarna_6	CUCAAGAGGCGAUCUCCCCCAGGCAGCUCGGCCCCACGAGCCAAACGGCCCCAGCAGAGAUCUCGGAGCCCGCCCCCCUGGAACCCCACGAUCGCCACCCUGGCCAAGACGAACACUCCA
influenza_pKISS_antarna_7	CCCGCUGUGCGGCACAACGUACUCAGACCUAAAGCGAGGUCCAAUAGGCCCAGGAACAGACCCAGGAGCCCAACGAAGUACCCCAAUACUGCCGCCCCUAUAUCAAUCACCACACACGAG
influenza_pKISS_antarna_8	CUCUUGUCGCACCAACCCCCCCGCCGCGGAAAUGCGUCCGCUGACACGACGACGAAUAACACGCCGCUCGCCAACCCGGGGCAACAAACUGGUGCAAACCUUUACCACAUUACAUUCCAC
influenza_pKISS_antarna_9	CUCACAACGCGCCCUUCAGGCCCAAGCGCCCCCCAAGGCGCACACCCCGGGGGUCCAUCCAACGCCACGGUUCAAAGGGCCAACGCAGUGGGCGCAUUCCCUGAUCGCCAAUCUCCAUGC
influenza_pKISS_antarna_10	CCCUCUUCGGGUCCAAAACUGUCCCCAGUACUAUUAUACUGCUACCUGCCUAUCCCCACUAGACAGUGCAAACUACGACAGAAACCCAAGGACCCUAACCUGGCCCACCUACUCUUCCUA
influenza_pKISS_antarna_11	UUUCCGUAUGCCAGACCCCCGCGCCGCUGCCCGACUGCAGCCUCCUCCUGCCCGAGAGCUACGAGCAAGGUUCACCCGCGGACUUUCGACUGGCACCACCCGACUCCCCCCUUCACGCGC
htcl_pKISS_antarna_2	CACUUCCCCUCUCUAAGUUAUUACUCGGCAUGGCGGCAACUAGAGAGGGCGCGAUUAACUACCGCGAUCCGCCAUGCCGUAAGCCGCAAAACAAUAUCCGGCCCAAUAUCACGAUUUCCU
htcl_pKISS_antarna_3	AUAUUAGCCACUGUUAUAACAAGAACGGCCGGGGGCCCGGAACAGUGGCGCGAAUACGAAGACCGCGCUCCCCCGGCCGACCGCGCCAGCCACACCGGGCGCCCAUCAACACCCGACAAC
htcl_pKISS_antarna_4	CUGUCUCCCCCGCAACCAUCCCCACGUGGACGGCCAACCAUUGCGGGGGGCGCCAUAACCAAACGCUCGGGCCGUCCACCAAGCCUGUACACCCCGAUAGGCCCUUCAACCCAUCUCCUC
htcl_pKISS_antarna_5	AUUGCCGCCCGGAGGCAAACAUCCCGGGGCAGGCCCCAAACCUCCGGGCGCCACACACGACUCGGCCCCGGCCUGCCCCAGAGGCAACAACCAAUAUGUGCCACCCAUCCCGCAUCCAAA
htcl_pKISS_antarna_6	CCGCCCACACUGGUGGCGACACCCAGCGCCGCCGCACCCCCACCAGUGUUUUCACCAAGCCGAAAAACAGCGGCGGCGCCCAGGACCCUUACCCCCAAGUCCAUCAACGACCUUGCCAAG
htcl_pKISS_antarna_7	AGGCGCGUGUUGAGCGCCACCCCCCGACGCCCACACAUCUGCUCAACACCGGGACUCACCUACCCGAAUUGUGGGCGUCACGGGCCCCCCCUACCUGUGGCCCGACCCCCCCACAAACUU
htcl_pKISS_antarna_8	ACUCAGUGCACGAGCAAGCUCAUCGCGGCCGGCAGAAUCGGCUCGUGCACCGACAGUUCAACACGGUGCCUGCCGGCCGAAACGUUCUCUCACCCGGGAACGCCCCCUCAUACCCCAAUC
htcl_pKISS_antarna_9	AUCCGACCCAAAGCCCGAUAUUACAGCCCGCCCGGCCUACGGCUUUGGGGCAUGUUGAGCUCAUGCCCCCCGGGCGGGCCCAGCUGCAAUUGUGUAUGCAGCACCUCCCACACAUACAGC
htcl_pKISS_antarna_10	CGGACAGCCGGCUCAACCCCCCCCCUGCCCGCUGCCACACUGAGCCGGCGCCACACAUAUACAGGCCCCGCAGCGGGCACUAUCGGCCCUUUCAUUCGCCGAGACACCACACCGACCACC
htcl_pKISS_antarna_11	AUGUACACGUUAUGCACAGACAACCGCCGGCCGACCGGAAGCAUAACGUGCCCAUCCAGAGUGGGCAAAGUCGGCCGGCUUCCGCAUCUCCUCGGUUUUGCGCCCCCUUUCCAAAUCUCC
hiv_pKISS_antarna_2	GCGAACCGUCUCCUGGCAAGAGUUUGCCAGGAGUUUCCGGUUCGCCAGACCAGAAUAACGGAUUACGCAUGGCACCGGAGGGGUCCGUUGCUUCAUGCACGCAACAGACCGAAACGCGAA
hiv_pKISS_antarna_3	CUCGACACACGCCGCCGUGCGCUCACGGCGGCGGAUGGUGUCGAGCCACGCACGCACCAGCAAACCAAGACGCGGCACGGCCCCGUGGCGCUCGUCUUAACCAUCCAACACAUCAGGUAC
hiv_pKISS_antarna_4	UGGGGCGGAGUGACGAUCCGCGCGGAUCGUCACCAGGCCGCCCCACCCCGUCACCACCCACUACCCAGGACCGCAGGGUACAAACCCGGCGCCGUCCUACGAUCCCACCACCUGUUCGAG
hiv_pKISS_antarna_5	AGGAGCGCCCAUGGUCCUGCUGGCAGGACCAUGAAACGCGCUCCUCCCCGCUUAUCAUUGCAGACCGGAGGGCCCAGGCCCCCGCCUCGGCUGCCUCCCGCGUUAGUCUCGUUUCCGCAG
hiv_pKISS_antarna_6	GCCUGUUAUGUCCGGUCUCGGACGAGACCGGACCUCUUAACAGGCUUCACCACUUCACAGGCAAUCAUCCGGGUAAGCGCGACCGCUCACCAACGGAUCGGACAAAUAGCAGAGCUCCAC
hiv_pKISS_antarna_7	CGCGGCCCACCGGACCCGAGCGUUCGGGUCCGGAUGAGGGCCGCGUCCAGCACACAAAAGCCAAUCGGGGCGGCCCGUCGCGAGACGAGCCACGCCCCAGCCAAACAGAAUCAUCGGCAG
hiv_pKISS_antarna_8	AGUGGGCCAGCGGCCCGGUCCGCACCGGGCCGCGAGGGGCCCACUCAAUUCAACACGCAGAAAACAGAGGUAUGCCGCGGAACCGCGACAUGGACCUCGGCCCAUAUACACCUCCGGCAC
hiv_pKISS_antarna_9	GCGCUGGUAGGACACGGACUAGCGUCCGUGUCCAAGAACCAGCGCUCUACUUCGUUCAUAGCAUACGCAGAGGCAGUCGGCCACGACAGCCAUUCUGCAGGAAAAACGUAUCUUCUCCAC
hiv_pKISS_antarna_10	GCGGGGCCAAACUUCUGGCUCCAGCCAGAAGUUAUCGGGCCCCGCAAAAGCCCCACCACGCACAAACGGGCGCACACCUCUAUAGGUCUGCAGGCCCGCGCCACCUUCACCGAUCGGCCG
hiv_pKISS_antarna_11	GGCGCUGCAUACCGUGCGGCACUCCGCACGGUAGCUGGCAGCGCCAACUGGAAUUACAACCUAAACCCUGCGGAAUGGAGAACUCCAGUCCUGGCAGGAGCGAGAACCGACAGCCCGCCC
wnv_pKISS_antarna_2	CACCACGCGCCGGGGGGGGGAAGAGUGGGGACCCCCCGGCGCGGGCGGACUGGCCGCCAACCCACUCCUAUCGUACGGCACUCAAUAUCGUCGACAACCCCCGCCGUACAAUGUCGACAG
wnv_pKISS_antarna_3	CCCUCGCGCGGCCCGGGCAGAAGAGGGGAAAACCGGGCCGCGCACCACAACCAGUGGUACUCCCCUCCUGCCGGCGCCACCACCGCAAAGUUCGUCCACAUCUGGCGCCCAAACGAACCC
wnv_pKISS_antarna_4	ACCCGGGGGCCGCGCGUUGGACUGGUGGCCCUCGCGCGGCCCCGCCCGCAAACCGGGCCCGCCACCAAAAUCGCAGGAGACAUAAUUACAGGAACCCAGAACCUCCUGCUUCGUUCCUUC
wnv_pKISS_antarna_5	CUGCCCCCACUGCCCAGAGCAACUAUCGCGGGUGGGCAGUGGGAGAGAACCCCUCUCUAUGCGAUAGACGUUCCUUUAACAAAGACGAACCAGGGAACAAACUUAAAGGAAACCCUGGAC
wnv_pKISS_antarna_6	GUCCCGGCCACCGGCGUUGGCAUCGACUUACCCGCCGGUGGCCCGCACACGUCGUGCGAAAAGUCGAAUGGAGCGUUGUAUCACCCACCGGCUGCCCAAGACACAACGCAACGCAGCCCG
wnv_pKISS_antarna_7	CAGAAGGAGCGGCCAGAAUCGAGAUUGUACCCCUGGCCGCUCCGCCAGAUUCACUGGCAAUACAAUCAGACAAGGGAACCAACAGUCACGGGCCCAAACCCAGUUCCCUUCCGGGCCCCC
wnv_pKISS_antarna_8	UUGAACGAAGGCCGUCAUUCUUGUGUCGUCUCGACGGCCUUCGGGUACCGAAGGUACCUCACGACACUUGGGCCGCGGGACAACCCAACAAAAGCAAGCAACCCCGCGGAAAGCUUUUUA
wnv_pKISS_antarna_9	ACGUUCGUUGCGUGUCCAACAAUCAUAUCGCAGACACGCAACGCUGCCGUGGAGGCAGACGAUAUGAACGGAGCGCCCAAAACUCCGAAGGCCCUUACAAAAUGGGCGCUAGAGGGCCAA
wnv_pKISS_antarna_10	CUAGUGAACCCAACAGCCCUUUUUUUUUCAACCUGUUGGGUUCUGCCUUUACCAGGCACAGAAAAAAAGCGAGGACCGAAAAAACGCGAGGGGGGAAUAAACUCGGUCCAAACCCCCCAC
wnv_pKISS_antarna_11	ACUUUGGGCCGCGAGGACAACAUUCGCGGCAUCCUCGCGGCCCGGCCUGGCCGAGGCCUCCCGCGAAGGGUCGGUGCAUUCCGUACCCCCGCUGCCGAUUCCAUGCACCUAUGCAGCGUC
